00000000000000000000000000000000000000000000000000000000000000
00000000000000000000000000000000000000000000000000000000000000
00000000000000000000000000000000000000000000000000000000000000
00000000000000000000000000000000000000000000000000000000000000
00000000000000000000000000000000000000000000000000000000000000
00000000000000000000000000000000000000000000000000000000000000
00000000000000000000000000000000000000000000000000000000000000
00000000000000000000000000000000000000000000000000000000000000
gggtggggg00000000000000000000000000000000000000000000000000000
12222222222222222300000000000000000000000000000000000000000000
45555555555555555600000000000000000000000000000000000000000000
78888888888888888900000000000000000000000000000000000000000000


